2,2,2,2,2,2,2,2
2,2,2,2,2,2,2,2
0,0,0,0,0,0,0,0
1,2,3,4,5,0,0,0
2,2,2,2,2,2,2,2
2,2,2,2,2,2,2,2